M,M,M,M,M,M,M,M
M,B,C,C,C,C,C,M
M,C,C,C,C,C,C,M
M,C,C,C,C,C,C,M
M,R,R,R,R,R,R,M
M,C,C,C,C,C,C,M
M,C,C,C,C,C,C_g,M
M,M,M,M,M,M,M,M