C,C,C,C,R,C,C,C,C,C,C
C,M,C,M,C,M,C,M,C,M,C
C,C,C,C,C,C,R,E,R,C,C
C,M,C,M,C,M,C,M,C,M,C
C,C,C,C,C,C,C,C,C,C,C
B,C,C,R,R,R,C,C,C,C,C_g