M,M,M,M,M,M,M,M,M,M,M,M,M
M,B,C,C,M,C,C,C,C,C,M,C,M
M,M,M,C,M,C,M,M,M,C,M,C,M
M,C,C,C,C,C,M,C,C,C,M,C,M
M,C,M,M,M,C,M,C,M,C,C,C,M
M,C,M,C,M,M,M,C,M,M,C,M,M
M,C,C,C,E,C,C,C,M,C,C,C,M
M,M,M,C,M,C,M,M,M,C,M,M,M
M,C,M,C,M,C,C,C,C,C,C,C,M
M,C,C,C,M,C,M,C,M,M,M,M,M
M,C,M,C,M,C,M,C,C,C,M,C_g,M
M,C,E,C,C,C,M,C,M,C,R,C,M
M,M,M,M,M,M,M,M,M,M,M,M,M